type octile
height 12
width 12
map
@@@@@@@@@@@@
@..........@
@.@@@@@....@
@.....@....@
@.@@@@@....@
@..........@
@.@@@@@....@
@.....@....@
@.@@@@@....@
@..........@
@..........@
@@@@@@@@@@@@