type octile
height 30
width 33
map
@@@@@@@@@@@@@@@@@@@@@@@@@@@@@@@@@
@..........@@....@..........@...@
@.@@@@@....@..@..@.....@..@.@.@.@
@.....@....#..@..@@@...@..@.@.@.@
@.@@@@@....@..@........@..@.@.@.@
@........@@@@@@@@@@@@@@@..@.@.@.@
@.@@@@@....@........@.....@...@.@
@.....@....@.@@@@@@.@..@@@@@@@@.@
@..@@@@....#.....@@.@..@........@
@....@@....@...@@@@.@..@@.......@
@...@@@@@@@@....@@@....@........@
@..........@@.....@@@@@@........@
@@@@@@@@@@..@@@...@@@@@@@@@.....@
@..........@@@@....@@@.......@@@@
@...@@@@@@@@..@@....@...........@
@..@@@@@@@.....@@@......@@@@@...@
@......@@........#.....@@...@@..@
@.....@@@@@......@@@@@@@.....@..@
@....@@@@@@@@....@..............@
@...@@@@@@@.....@@..............@
@....@@@@@.....@@@@@@@@.........@
@..............@@...............@
@..@@@@@@@@@@#@@@@@..@@@@@@@@...@
@........@@@@.....@........@@@..@
@@@@@@@..@@....@..@@@.......@@..@
@.......@@.....@....@@@@.....@..@
@..@@@@@@......@@@...........@..@
@.......#........@......@@...@..@
@.......@........@.....@@@@.....@
@@@@@@@@@@@@@@@@@@@@@@@@@@@@@@@@@