type octile
height 32
width 40
map
@@@@@@@@@@@@@@@@@@@@@@@@@@@@@@@@@@@@@@@@
@......................................@
@......................................@
@......................................@
@......................................@
@......................................@
@......................................@
@......................................@
@......................................@
@......................................@
@......................................@
@......................................@
@......................................@
@......................................@
@......................................@
@......................................@
@......................................@
@......................................@
@........@@@@@@@@@@@@@@@@@@@@..........@
@........@...@..............@..........@
@........@.@.@.@@@@@@@@@@@@.@..........@
@........@.@.@.@............@@.........@
@........@.@.@.@.@@@@@@@@@@@@@.........@
@........@.@.@.@.............@.........@
@........@.@.@.@@@@@@@@@@@@@.@.........@
@........@.@.@.@.............@.........@
@........@.@.@.@.@@@@@@@@@@@@@.........@
@........@.@.@.@.@...@...@...@.........@
@..........@.@.@.@.@.@.@.@.@.@.........@
@..........@.@.@.@.@.@.@.@.@.@.........@
@..........@...@...@...@...@...........@
@@@@@@@@@@@@@@@@@@@@@@@@@@@@@@@@@@@@@@@@
