type octile
height 20
width 20
map
TTTTTTTTTTTTTTTTTTTT
T..................T
T..................T
T..................T
T..................T
T..................T
T..................T
T..................T
T..................T
T..................T
T..................T
T..................T
T..................T
T..................T
T..................T
T..................T
T..................T
T..................T
T..................T
TTTTTTTTTTTTTTTTTTTT
